****************************
*                          *
*                          *
*                          *
*                          *
*                          *
*                          *
*                          *
*                          *
*                          *
*                          *
*                          *
*                          *
*                          *
*                          *
*                          *
*                          *
*                          *
*                          *
*                          *
*                          *
*                          *
*                          *
*       p                  *
*                          *
*                          *
*                          *
*                          *
*                          *
*                          *
****************************
